"a" = (/turf/unsimulated/ground,/area/space)
"b" = (/obj/effect/landmark{name = "JoinLate"},/turf/unsimulated/ground,/area/space)
"c" = (/obj/effect/landmark{name = "Observer-start"},/turf/unsimulated/ground,/area/space)
"d" = (/obj/effect/landmark/start{name = "BDW Feldchirurg"},/turf/unsimulated/ground,/area/space)
"e" = (/obj/effect/landmark/start{name = "BDW Bote"},/turf/unsimulated/ground,/area/space)

(1,1,1) = {"
aaaaa
abcaa
adaaa
eaaaa
aaaaa
"}
