"ad" = (/turf/simulated/floor/tiled/dark,/area/coldwar/underground/bunker)
"af" = (/turf/unsimulated/ground,/area/coldwar/underground/bunker)
"ai" = (/obj/machinery/light/small/warmtint{dir = 1},/turf/simulated/floor/tiled/dark,/area/coldwar/underground/bunker)
"aj" = (/obj/structure/stairs/large/east,/turf/unsimulated/ground,/area/coldwar/underground/bunker)
"ak" = (/obj/structure/gasradiator{icon_state = "holycross"; name = "cross"},/turf/simulated/wall/concrete_grey,/area/coldwar/underground/bunker)
"aO" = (/obj/structure/sign/ass_flag,/turf/simulated/wall/concrete_grey,/area/coldwar/underground)
"bA" = (/obj/effect/decal/cleanable/dirt,/obj/structure/ladder/up{target_up = 1},/turf/simulated/floor/plating,/area/coldwar/underground)
"cw" = (/obj/structure/fence{dir = 4},/turf/unsimulated/bridge,/area/coldwar/underground)
"iI" = (/turf/unsimulated/bridge,/area/coldwar/underground)
"tx" = (/turf/simulated/wall/concrete_grey,/area/coldwar/underground)
"tK" = (/obj/effect/decal/cleanable/dirt,/turf/unsimulated/bridge,/area/coldwar/underground)
"tY" = (/obj/structure/fence/door,/turf/unsimulated/bridge,/area/coldwar/underground)
"uW" = (/obj/effect/decal/cleanable/dirt,/turf/simulated/floor/plating,/area/coldwar/sewer)
"wb" = (/obj/structure/stairs/large/west,/turf/unsimulated/ground,/area/coldwar/underground/bunker)
"wi" = (/turf/unsimulated/ground/snow,/area/space)
"yR" = (/turf/unsimulated/wall/planetary/sif,/area/space)
"CJ" = (/turf/simulated/floor/sewerwater,/area/coldwar/sewer)
"DR" = (/obj/machinery/light/small/red,/obj/effect/decal/cleanable/dirt,/turf/unsimulated/bridge,/area/coldwar/underground)
"Jd" = (/obj/effect/decal/cleanable/dirt,/obj/random/trash,/turf/unsimulated/bridge,/area/coldwar/underground)
"My" = (/turf/simulated/wall/concrete_grey,/area/coldwar/underground/bunker)
"Nu" = (/obj/effect/decal/cleanable/dirt,/obj/random/trash,/turf/simulated/floor/plating,/area/coldwar/sewer)
"On" = (/obj/machinery/light/small/red,/obj/effect/decal/cleanable/dirt,/turf/simulated/floor/plating,/area/coldwar/sewer)
"Xr" = (/obj/structure/railing{dir = 1},/turf/simulated/floor/sewerwater,/area/coldwar/sewer)
"Yr" = (/obj/structure/railing,/turf/simulated/floor/sewerwater,/area/coldwar/sewer)
"ZZ" = (/turf/simulated/mineral,/area/coldwar/underground)

(1,1,1) = {"
ZZZZZZZZZZZZZZZZZZZZZZZZZZZZZZZZZZZZZZZZZZZZZZZZZZZZZZZZZZZZZZZZZZZZZZZZZZZZZZZZZZZZZZZZZZZZZZZZZZZZZZZZZZZZZZZZZZZZZZZZZZZZZZZZZZZZZZZZZZZZZZZZZZZZZZ
ZZZZZZZZZZZZZZZZZZZZZZZZZZZZZZZZZZZZZZZZZZZZZZZZZZZZZZZZZZZZZZZZZZZZZZZZZZZZZZZZZZZZZZZZZZZZZZZZZZZZZZZZZZZZZZZZZZZZZZZZZZZZZZZZZZZZZZZZZZZZZZZZZZZZZZ
ZZZZZZZZZZZZZZZZZZZZZZZZZZZZZZZZZZZZZZZZZZZZZZZZZZZZZZZZZZZZZZZZZZZZZZZZZZZZZZZZZZZZZZZZZZZZZZZZZZZZZZZZZZZZZZZZZZZZZZZZZZZZZZZZZZZZZZZZZZZZZZZZZZZZZZ
ZZZZZZZZZZZZZZZZZZZZZZZZZZZZZZZZZZZZZZZZZZZZZZZZZZZZZZZZZZZZZZZZZZZZZZZZZZZZZZZZZZZZZZZZZZZZZZZZZZZZZZZZZZZZZZZZZZZZZZZZZZZZZZZZZZZZZZZZZZZZZZZZZZZZZZ
ZZZZZZZZZZZZZZZZZZZZZZZZZZZZZZZZZZZZZZZZZZZZZZZZZZZZZZZZZZZZZZZZZZZZZZZZZZZZZZZZZZZZZZZZZZZZZZZZZZZZZZZZZZZZZZZZZZZZZZZZZZZZZZZZZZZZZZZZZZZZZZZZZZZZZZ
ZZZZZZZZZZZZZZZZZZZZZZZZZZZZZZZZZZZZZZZZZZZZZZZZZZZZZZZZZZZZZZZZZZZZZZZZZZZZZZZZZZZZZZZZZZZZZZZZZZZZZZZZZZZZZZZZZZZZZZZZZZZZZZZZZZZZZZZZZZZZZZZZZZZZZZ
ZZZZZZZZZZZZZZZZZZZZZZZZZZZZZZZZZZZZZZZZZZZZZZZZZZZZZZZZZZZZZZZZZZZZZZZZZZZZZZZZZZZZZZZZZZZZZZZZZZZZZZZZZZZZZZZZZZZZZZZZZZZZZZZZZZZZZZZZZZZZZZZZZZZZZZ
ZZZZZZZZZZZZZZZZZZZZZZZZZZZZZZZZZZZZZZZZZZZZZZZZZZZZZZZZZZZZZZZZZZZZZZZZZZZZZZZZZZZZZZZZZZZZZZZZZZZZZZZZZZZZZZZZZZZZZZZZZZZZZZZZZZZZZZZZZZZZZZZZZZZZZZ
ZZZZZZZZZZZZZZZZZZZZZZZZZZZZZZZZZZZZZZZZZZZZZZZZZZZZZZZZZZZZZZZZZZZZZZZZZZZZZZZZZZZZZZZZZZZZZZZZZZZZZZZZZZZZZZZZZZZZZZZZZZZZZZZZZZZZZZZZZZZZZZZZZZZZZZ
ZZZZZZZZZZZZZZZZZZZZZZZZZZZZZZZZZZZZZZZZZZZZZZZZZZZZZZZZZZZZZZZZZZZZZZZZZZZZZZZZZZZZZZZZZZZZZZZZZZZZZZZZZZZZZZZZZZZZZZZZZZZZZZZZZZZZZZZZZZZZZZZZZZZZZZ
ZZZZZZZZZZZZZZZZZZZZZZZZZZZZZZZZZZZZZZZZZZZZZZZZZZZZZZZZZZZZZZZZZZZZZZZZZZZZZZZZZZZZZZZZZZZZZZZZZZZZZZZZZZZZZZZZZZZZZZZZZZZZZZZZZZZZZZZZZZZZZZZZZZZZZZ
ZZZZZZZZZZZZZZZZZZZZZZZZZZZZZZZZZZZZZZZZZZZZZZZZZZZZZZZZZZZZZZZZZZZZZZZZZZZZZZZZZZZZZZZZZZZZZZZZZZZZZZZZZZZZZZZZZZZZZZZZZZZZZZZZZZZZZZZZZZZZZZZZZZZZZZ
ZZZZZZZZZZZZZZZZZZZZZZZZZZZZZZZZZZZZZZZZZZZZZZZZZZZZZZZZZZZZZZZZZZZZZZZZZZZZZZZZZZZZZZZZZZZZZZZZZZZZZZZZZZZZZZZZZZZZZZZZZZZZZZZZZZZZZZZZZZZZZZZZZZZZZZ
ZZZZZZZZZZZZZZZZZZZZZZZZZZZZZZZZZZZZZZZZZZZZZZZZZZZZZZZZZZZZZZZZZZZZZZZZZZZZZZZZZZZZZZZZZZZZZZZZZZZZZZZZZZZZZZZZZZZZZZZZZZZZZZZZZZZZZZZZZZZZZZZZZZZZZZ
ZZZZZZZZZZZZZZZZZZZZZZZZZZZZZZZZZZZZZZZZZZZZZZZZZZZZZZZZZZZZZZZZZZZZZZZZZZZZZZZZZZZZZZZZZZZZZZZZZZZZZZZZZZZZZZZZZZZZZZZZZZZZZZZZZZZZZZZZZZZZZZZZZZZZZZ
ZZZZZZZZZZZZZZZZZZZZZZZZZZZZZZZZZZZZZZZZZZZZZZZZZZZZZZZZZZZZZZZZZZZZZZZZZZZZZZZZZZZZZZZZZZZZZZZZZZZZZZZZZZZZZZZZZZZZZZZZZZZZZZZZZZZZZZZZZZZZZZZZZZZZZZ
ZZZZZZZZZZZZZZZZZZZZZZZZZZZZZZZZZZZZZZZZZZZZZZZZZZZZZZZZZZZZZZZZZZZZZZZZZZZZZZZZZZZZZZZZZZZZZZZZZZZZZZZZZZZZZZZZZZZZZZZZZZZZZZZZZZZZZZZZZZZZZZZZZZZZZZ
ZZZZZZZZZZZZZZZZZZZZZZZZZZZZZZZZZZZZZZZZZZZZZZZZZZZZZZZZZZZZZZZZZZZZZZZZZZZZZZZZZZZZZZZZZZZZZZZZZZZZZZZZZZZZZZZZZZZZZZZZZZZZZZZZZZZZZZZZZZZZZZZZZZZZZZ
ZZZZZZZZZZZZZZZZZZZZZZZZZZZZZZZZZZZZZZZZZZZZZZZZZZZZZZZZZZZZZZZZZZZZZZZZZZZZZZZZZZZZZZZZZZZZZZZZZZZZZZZZZZZZZZZZZZZZZZZZZZZZZZZZZZZZZZZZZZZZZZZZZZZZZZ
ZZZZZZZZZZZZZZZZZZZZZZZZZZZZZZZZZZZZZZZZZZZZZZZZZZZZZZZZZZZZZZZZZZZZZZZZZZZZZZZZZZZZZZZZZZZZZZZZZZZZZZZZZZZZZZZZZZZZZZZZZZZZZZZZZZZZZZZZZZZZZZZZZZZZZZ
ZZZZZZZZZZZZZZZZZZZZZZZZZZZZZZZZZZZZZZZZZZZZZZZZZZZZZZZZZZZZZZZZZZZZZZZZZZZZZZZZZZZZZZZZZZZZZZZZZZZZZZZZZZZZZZZZZZZZZZZZZZZZZZZZZZZZZZZZZZZZZZZZZZZZZZ
ZZZZZZZZZZZZZZZZZZZZZZZZZZZZZZZZZZZZZZZZZZZZZZZZZZZZZZZZZZZZZZZZZZZZZZZZZZZZZZZZZZZZZZZZZZZZZZZZZZZZZZZZZZZZZZZZZZZZZZZZZZZZZZZZZZZZZZZZZZZZZZZZZZZZZZ
ZZZZZZZZZZZZZZZZZZZZZZZZZZZZZZZZZZZZZZZZZZZZZZZZZZZZZZZZZZZZZZZZZZZZZZZZZZZZZZZZZZZZZZZZZZZZZZZZZZZZZZZZZZZZZZZZZZZZZZZZZZZZZZZZZZZZZZZZZZZZZZZZZZZZZZ
ZZZZZZZZZZZZZZZZZZZZZZZZZZZZZZZZZZZZZZZZZZZZZZZZZZZZZZZZZZZZZZZZZZZZZZZZZZZZZZZZZZZZZZZZZZZZZZZZZZZZZZZZZZZZZZZZZZZZZZZZZZZZZZZZZZZZZZZZZZZZZZZZZZZZZZ
ZZZZZZZZZZZZZZZZZZZZZZZZZZZZZZZZZZZZZZZZZZZZZZZZZZZZZZZZZZZZZZZZZZZZZZZZZZZZZZZZZZZZZZZZZZZZZZZZZZZZZZZZZZZZZZZZZZZZZZZZZZZZZZZZZZZZZZZZZZZZZZZZZZZZZZ
ZZZZZZZZZZZZZZZZZZZZZZZZZZZZZZZZZZZZZZZZZZZZZZZZZZZZZZZZZZZZZZZZZZZZZZZZZZZZZZZZZZZZZZZZZZZZZZZZZZZZZZZZZZZZZZZZZZZZZZZZZZZZZZZZZZZZZZZZZZZZZZZZZZZZZZ
ZZZZZZZZZZZZZZZZZZZZZZZZZZZZZZZZZZZZZZZZZZZZZZZZZZZZZZZZZZZZZZZZZZZZZZZZZZZZZZZZZZZZZZZZZZZZZZZZZZZZZZZZZZZZZZZZZZZZZZZZZZZZZZZZZZZZZZZZZZZZZZZZZZZZZZ
ZZZZZZZZZZZZZZZZZZZZZZZZZZZZZZZZZZZZZZZZZZZZZZZZZZZZZZZZZZZZZZZZZZZZZZZZZZZZZZZZZZZZZZZZZZZZZZZZZZZZZZZZZZZZZZZZZZZZZZZZZZZZZZZZZZZZZZZZZZZZZZZZZZZZZZ
ZZZZZZZZZZZZZZZZZZZZZZZZZZZZZZZZZZZZZZZZZZZZZZZZZZZZZZZZZZZZZZZZZZZZZZZZZZZZZZZZZZZZZZZZZZZZZZZZZZZZZZZZZZZZZZZZZZZZZZZZZZZZZZZZZZZZZZZZZZZZZZZZZZZZZZ
ZZZZZZZZZZZZZZZZZZZZZZZZZZZZZZZZZZZZZZZZZZZZZZZZZZZZZZZZZZZZZZZZZZZZZZZZZZZZZZZZZZZZZZZZZZZZZZZZZZZZZZZZZZZZZZZZZZZZZZZZZZZZZZZZZZZZZZZZZZZZZZZZZZZZZZ
ZZZZZZZZZZZZZZZZZZZZZZZZZZZZZZZZZZZZZZZZZZZZZZZZZZZZZZZZZZZZZZZZZZZZZZZZZZZZZZZZZZZZZZZZZZZZZZZZZZZZZZZZZZZZZZZZZZZZZZZZZZZZZZZZZZZZZZZZZZZZZZZZZZZZZZ
ZZZZZZZZZZZZZZZZZZZZZZZZZZZZZZZZZZZZZZZZZZZZZZZZZZZZZZZZZZZZZZZZZZZZZZZZZZZZZZZZZZZZZZZZZZZZZZZZZZZZZZZZZZZZZZZZZZZZZZZZZZZZZZZZZZZZZZZZZZZZZZZZZZZZZZ
ZZZZZZZZZZZZZZZZZZZZZZZZZZZZZZZZZZZZZZZZZZZZZZZZZZZZZZZZZZZZZZZZZZZZZZZZZZZZZZZZZZZZZZZZZZZZZZZZZZZZZZZZZZZZZZZZZZZZZZZZZZZZZZZZZZZZZZZZZZZZZZZZZZZZZZ
ZZZZZZZZZZZZZZZZZZZZZZZZZZZZZZZZZZZZZZZZZZZZZZZZZZZZZZZZZZZZZZZZZZZZMyMyMyMyMyadadadMyadadadMyMyMyMyMyZZZZZZZZZZZZZZZZZZZZZZZZZZZZZZZZZZZZZZZZZZZZZZZZ
ZZZZZZZZZZZZZZZZZZZZZZZZZZZZZZZZZZZZZZZZZZZZZZZZZZZZZZZZZZZZZZZZZZZZMyafwbadaiadadadaiadadadaiadafajMyZZZZZZZZZZZZZZZZZZZZZZZZZZZZZZZZZZZZZZZZZZZZZZZZ
ZZZZZZZZZZZZZZZZZZZZZZZZZZZZZZZZZZZZZZZZZZZZZZZZZZZZZZZZZZZZZZZZZZZZMyafwbadadadadadadadadadadadafajMyZZZZZZZZZZZZZZZZZZZZZZZZZZZZZZZZZZZZZZZZZZZZZZZZ
ZZZZZZZZZZZZZZZZZZZZZZZZZZZZZZZZZZZZZZZZZZZZZZZZZZZZZZZZZZZZZZZZZZZZMyMyMyMyMyadadadakadadadMyMyMyMyMyZZZZZZZZZZZZZZZZZZZZZZZZZZZZZZZZZZZZZZZZZZZZZZZZ
ZZZZZZZZZZZZZZZZZZZZZZZZZZZZZZZZZZZZZZZZZZZZZZZZZZZZZZZZZZZZZZZZZZZZZZZZZZZZZZZZZZZZZZZZZZZZZZZZZZZZZZZZZZZZZZZZZZZZZZZZZZZZZZZZZZZZZZZZZZZZZZZZZZZZZZ
ZZZZZZZZZZZZZZZZZZZZZZZZZZZZZZZZZZZZZZZZZZZZZZZZZZZZZZZZZZZZZZZZZZZZZZZZZZZZZZZZZZZZZZZZZZZZZZZZZZZZZZZZZZZZZZZZZZZZZZZZZZZZZZZZZZZZZZZZZZZZZZZZZZZZZZ
ZZZZZZZZZZZZZZZZZZZZZZZZZZZZZZZZZZZZZZZZZZZZZZZZZZZZZZZZZZZZZZZZZZZZZZZZZZZZZZZZZZZZZZZZZZZZZZZZZZZZZZZZZZZZZZZZZZZZZZZZZZZZZZZZZZZZZZZZZZZZZZZZZZZZZZ
ZZZZZZZZZZZZZZZZZZZZZZZZZZZZZZZZZZZZZZZZZZZZZZZZZZZZZZZZZZZZZZZZZZZZZZZZZZZZZZZZZZZZZZZZZZZZZZZZZZZZZZZZZZZZZZZZZZZZZZZZZZZZZZZZZZZZZZZZZZZZZZZZZZZZZZ
ZZZZZZZZZZZZZZZZZZZZZZZZZZZZZZZZZZZZZZZZZZZZZZZZZZZZZZZZZZZZZZZZZZZZZZZZZZZZZZZZZZZZZZZZZZZZZZZZZZZZZZZZZZZZZZZZZZZZZZZZZZZZZZZZZZZZZZZZZZZZZZZZZZZZZZ
ZZZZZZZZZZZZZZZZZZZZZZZZZZZZZZZZZZZZZZZZZZZZZZZZZZZZZZZZZZZZZZZZZZZZZZZZZZZZZZZZZZZZZZZZZZZZZZZZZZZZZZZZZZZZZZZZZZZZZZZZZZZZZZZZZZZZZZZZZZZZZZZZZZZZZZ
ZZZZZZZZZZZZZZZZZZZZZZZZZZZZZZZZZZZZZZZZZZZZZZZZZZZZZZZZZZZZZZZZZZZZZZZZZZZZZZZZZZZZZZZZZZZZZZZZZZZZZZZZZZZZZZZZZZZZZZZZZZZZZZZZZZZZZZZZZZZZZZZZZZZZZZ
ZZZZZZZZZZZZZZZZZZZZZZZZZZZZZZZZZZZZZZZZZZZZZZZZZZZZZZZZZZZZZZZZZZZZZZZZZZZZZZZZZZZZZZZZZZZZZZZZZZZZZZZZZZZZZZZZZZZZZZZZZZZZZZZZZZZZZZZZZZZZZZZZZZZZZZ
ZZZZZZZZZZZZZZZZZZZZZZZZZZZZZZZZZZZZZZZZZZZZZZZZZZZZZZZZZZZZZZZZZZZZZZZZZZZZZZZZZZZZZZZZZZZZZZZZZZZZZZZZZZZZZZZZZZZZZZZZZZZZZZZZZZZZZZZZZZZZZZZZZZZZZZ
ZZZZZZZZZZZZZZZZZZZZZZZZZZZZZZZZZZZZZZZZZZZZZZZZZZZZZZZZZZZZZZZZZZZZZZZZZZZZZZZZZZZZZZZZZZZZZZZZZZZZZZZZZZZZZZZZZZZZZZZZZZZZZZZZZZZZZZZZZZZZZZZZZZZZZZ
ZZZZZZZZZZZZZZZZZZZZZZZZZZZZZZZZZZZZZZZZZZZZZZZZZZZZZZZZZZZZZZZZZZZZZZZZZZZZZZZZZZZZZZZZZZZZZZZZZZZZZZZZZZZZZZZZZZZZZZZZZZZZZZZZZZZZZZZZZZZZZZZZZZZZZZ
ZZZZZZZZZZZZZZZZZZZZZZZZZZZZZZZZZZZZZZZZZZZZZZZZZZZZZZZZZZZZZZZZZZZZZZZZZZZZZZZZZZZZZZZZZZZZZZZZZZZZZZZZZZZZZZZZZZZZZZZZZZZZZZZZZZZZZZZZZZZZZZZZZZZZZZ
ZZZZZZZZZZZZZZZZZZZZZZZZZZZZZZZZZZZZZZZZZZZZZZZZZZZZZZZZZZZZZZZZZZZZZZZZZZZZZZZZZZZZZZZZZZZZZZZZZZZZZZZZZZZZZZZZZZZZZZZZZZZZZZZZZZZZZZZZZZZZZZZZZZZZZZ
ZZZZZZZZZZZZZZZZZZZZZZZZZZZZZZZZZZZZZZZZZZZZZZZZZZZZZZZZZZZZZZZZZZZZZZZZZZZZZZZZZZZZZZZZZZZZZZZZZZZZZZZZZZZZZZZZZZZZZZZZZZZZZZZZZZZZZZZZZZZZZZZZZZZZZZ
ZZZZZZZZZZZZZZZZZZZZZZZZZZZZZZZZZZZZZZZZZZZZZZZZZZZZZZZZZZZZZZZZZZZZZZZZZZZZZZZZZZZZZZZZZZZZZZZZZZZZZZZZZZZZZZZZZZZZZZZZZZZZZZZZZZZZZZZZZZZZZZZZZZZZZZ
ZZZZZZZZZZZZZZZZZZZZZZZZZZZZZZZZZZZZZZZZZZZZZZZZZZZZZZZZZZZZZZZZZZZZZZZZZZZZZZZZZZZZZZZZZZZZZZZZZZZZZZZZZZZZZZZZZZZZZZZZZZZZZZZZZZZZZZZZZZZZZZZZZZZZZZ
ZZZZZZZZZZZZZZZZZZZZZZZZZZZZZZZZZZZZZZZZZZZZZZZZZZZZZZZZZZZZZZZZZZZZZZZZZZZZZZZZZZZZZZZZZZZZZZZZZZZZZZZZZZZZZZZZZZZZZZZZZZZZZZZZZZZZZZZZZZZZZZZZZZZZZZ
ZZZZZZZZZZZZZZZZZZZZZZZZZZZZZZZZZZZZZZZZZZZZZZZZZZZZZZZZZZZZZZZZZZZZZZZZZZZZZZZZZZZZZZZZZZZZZZZZZZZZZZZZZZZZZZZZZZZZZZZZZZZZZZZZZZZZZZZZZZZZZZZZZZZZZZ
ZZZZZZZZZZZZZZZZZZZZZZZZZZZZZZZZZZZZZZZZZZZZZZZZZZZZZZZZZZZZZZZZZZZZZZZZZZZZZZZZZZZZZZZZZZZZZZZZZZZZZZZZZZZZZZZZZZZZZZZZZZZZZZZZZZZZZZZZZZZZZZZZZZZZZZ
ZZZZZZZZZZZZZZZZZZZZZZZZZZZZZZZZZZZZZZZZZZZZZZZZZZZZZZZZZZZZZZZZZZZZZZZZZZZZZZZZZZZZZZZZZZZZZZZZZZZZZZZZZZZZZZZZZZZZZZZZZZZZZZZZZZZZZZZZZZZZZZZZZZZZZZ
ZZZZZZZZZZZZZZZZZZZZZZZZZZZZZZZZZZZZZZZZZZZZZZZZZZZZZZZZZZZZZZZZZZZZZZZZZZZZZZZZZZZZZZZZZZZZZZZZZZZZZZZZZZZZZZZZZZZZZZZZZZZZZZZZZZZZZZZZZZZZZZZZZZZZZZ
ZZZZZZZZZZZZZZZZZZZZZZZZZZZZZZZZZZZZZZZZZZZZZZZZZZZZZZZZZZZZZZZZZZZZZZZZZZZZZZZZZZZZZZZZZZZZZZZZZZZZZZZZZZZZZZZZZZZZZZZZZZZZZZZZZZZZZZZZZZZZZZZZZZZZZZ
ZZZZZZZZZZZZZZZZZZZZZZZZZZZZZZZZZZZZZZZZZZZZZZZZZZZZZZZZZZZZZZZZZZZZZZZZZZZZZZZZZZZZZZZZZZZZZZZZZZZZZZZZZZZZZZZZZZZZZZZZZZZZZZZZZZZZZZZZZZZZZZZZZZZZZZ
ZZZZZZZZZZZZZZZZZZZZZZZZZZZZZZZZZZZZZZZZZZZZZZZZZZZZZZZZZZZZZZZZZZZZZZZZZZZZZZZZZZZZZZZZZZZZZZZZZZZZZZZZZZZZZZZZZZZZZZZZZZZZZZZZZZZZZZZZZZZZZZZZZZZZZZ
ZZZZZZZZZZZZZZZZZZZZZZZZZZZZZZZZZZZZZZZZZZZZZZZZZZZZZZZZZZZZZZZZZZZZZZZZZZZZZZZZZZZZZZZZZZZZZZZZZZZZZZZZZZZZZZZZZZZZZZZZZZZZZZZZZZZZZZZZZZZZZZZZZZZZZZ
ZZZZZZZZZZZZZZZZZZZZZZZZZZZZZZZZZZZZZZZZZZZZZZZZZZZZZZZZZZZZZZZZZZZZZZZZZZZZZZZZZZZZZZZZZZZZZZZZZZZZZZZZZZZZZZZZZZZZZZZZZZZZZZZZZZZZZZZZZZZZZZZZZZZZZZ
ZZZZZZZZZZZZZZZZZZZZZZZZZZZZZZZZZZZZZZZZZZZZZZZZZZZZZZZZZZZZZZZZZZZZZZZZZZZZZZZZZZZZZZZZZZZZZZZZZZZZZZZZZZZZZZZZZZZZZZZZZZZZZZZZZZZZZZZZZZZZZZZZZZZZZZ
ZZZZZZZZZZZZZZZZZZZZZZZZZZZZZZZZZZZZZZZZZZZZZZZZZZZZZZZZZZZZZZZZZZZZZZZZZZZZZZZZZZZZZZZZZZZZZZZZZZZZZZZZZZZZZZZZZZZZZZZZZZZZZZZZZZZZZZZZZZZZZZZZZZZZZZ
ZZZZZZZZZZZZZZZZZZZZZZZZZZZZZZZZZZZZZZZZZZZZZZZZZZZZZZZZZZZZZZZZZZZZZZZZZZZZZZZZZZZZZZZZZZZZZZZZZZZZZZZZZZZZZZZZZZZZZZZZZZZZZZZZZZZZZZZZZZZZZZZZZZZZZZ
ZZZZZZZZZZZZZZZZZZZZZZZZZZZZZZZZZZZZZZZZZZZZZZZZZZZZZZZZZZZZZZZZZZZZZZZZZZZZZZZZZZZZZZZZZZZZZZZZZZZZZZZZZZZZZZZZZZZZZZZZZZZZZZZZZZZZZZZZZZZZZZZZZZZZZZ
ZZZZZZZZZZZZZZZZZZZZZZZZZZZZZZZZZZZZZZZZZZZZZZZZZZZZZZZZZZZZZZZZZZZZZZZZZZZZZZZZZZZZZZZZZZZZZZZZZZZZZZZZZZZZZZZZZZZZZZZZZZZZZZZZZZZZZZZZZZZZZZZZZZZZZZ
ZZZZZZZZZZZZZZZZZZZZZZZZZZZZZZZZZZZZZZZZZZZZZZZZZZZZZZZZZZZZZZZZZZZZZZZZZZZZZZZZZZZZZZZZZZZZZZZZZZZZZZZZZZZZZZZZZZZZZZZZZZZZZZZZZZZZZZZZZZZZZZZZZZZZZZ
ZZZZZZZZZZZZZZZZZZZZZZZZZZZZZZZZZZZZZZZZZZZZZZZZZZZZZZZZZZZZZZZZZZZZZZZZZZZZZZZZZZZZZZZZZZZZZZZZZZZZZZZZZZZZZZZZZZZZZZZZZZZZZZZZZZZZZZZZZZZZZZZZZZZZZZ
ZZZZZZZZZZZZZZZZZZZZZZZZZZZZZZZZZZZZZZZZZZZZZZZZZZZZZZZZZZZZZZZZZZZZZZZZZZZZZZZZZZZZZZZZZZZZZZZZZZZZZZZZZZZZZZZZZZZZZZZZZZZZZZZZZZZZZZZZZZZZZZZZZZZZZZ
ZZZZZZZZZZZZZZZZZZZZZZZZZZZZZZZZZZZZZZZZZZZZZZZZZZZZZZZZZZZZZZZZZZZZZZZZZZZZZZZZZZZZZZZZZZZZZZZZZZZZZZZZZZZZZZZZZZZZZZZZZZZZZZZZZZZZZZZZZZZZZZZZZZZZZZ
ZZZZZZZZZZZZZZZZZZZZZZZZZZZZZZZZZZZZZZZZZZZZZZZZZZZZZZZZZZZZZZZZZZZZZZZZZZZZZZZZZZZZZZZZZZZZZZZZZZZZZZZZZZZZZZZZZZZZZZZZZZZZZZZZZZZZZZZZZZZZZZZZZZZZZZ
ZZZZZZZZZZZZZZZZZZZZZZZZZZZZZZZZZZZZZZZZZZZZZZZZZZZZZZZZZZZZZZZZZZZZZZZZZZZZZZZZZZZZZZZZZZZZZZZZZZZZZZZZZZZZZZZZZZZZZZZZZZZZZZZZZZZZZZZZZZZZZZZZZZZZZZ
ZZZZZZZZZZZZZZZZZZZZZZZZZZZZZZZZZZZZZZZZZZZZZZZZZZZZZZZZZZZZZZZZZZZZZZZZZZZZZZZZZZZZZZZZZZZZZZZZZZZZZZZZZZZZZZZZZZZZZZZZZZZZZZZZZZZZZZZZZZZZZZZZZZZZZZ
"}
(1,1,2) = {"
wiwiwiwiwiwiwiwiwiwiwiwiwiwiwiwiwiwiwiwiwiwiwiwiwiwiwiwiwiwiwiwiwiwiwiwiwiwiwiwiwiwiwiwiwiwiwiwiwiwiwiwiwiwiwiwiwiwiwiwiwiwiwiwiwiwiwiwiwiwiwiwiwiwiwi
wiwiwiwiwiwiwiwiwiwiwiwiwiwiwiwiwiwiwiwiwiwiwiwiwiwiwiwiwiwiwiwiwiwiwiwiwiwiwiwiwiwiwiwiwiwiwiwiwiwiwiwiwiwiwiwiwiwiwiwiwiwiwiwiwiwiwiwiwiwiwiwiwiwiwi
wiwiwiwiwiwiwiwiwiwiwiwiwiwiwiwiwiwiwiwiwiwiwiwiwiwiwiwiwiwiwiwiwiwiwiwiwiwiwiwiwiwiwiwiwiwiwiwiwiwiwiwiwiwiwiwiwiwiwiwiwiwiwiwiwiwiwiwiwiwiwiwiwiwiwi
wiwiwiwiwiwiwiwiwiwiwiwiwiwiwiwiwiwiwiwiwiwiwiwiwiwiwiwiwiwiwiwiwiwiwiwiwiwiwiwiwiwiwiwiwiwiwiwiwiwiwiwiwiwiwiwiwiwiwiwiwiwiwiwiwiwiwiwiwiwiwiwiwiwiwi
wiwiwiwiwiwiwiwiwiwiwiwiwiwiwiwiwiwiwiwiwiwiwiwiwiwiwiwiwiwiwiwiwiwiwiwiwiwiwiwiwiwiwiwiwiwiwiwiwiwiwiwiwiwiwiwiwiwiwiwiwiwiwiwiwiwiwiwiwiwiwiwiwiwiwi
wiwiwiwiwiwiwiwiwiwiwiwiwiwiwiwiwiwiwiwiwiwiwiwiwiwiwiwiwiwiwiwiwiwiwiwiwiwiwiwiwiwiwiwiwiwiwiwiwiwiwiwiwiwiwiwiwiwiwiwiwiwiwiwiwiwiwiwiwiwiwiwiwiwiwi
wiwiwiwiwiwiwiwiwiwiwiwiwiwiwiwiwiwiwiwiwiwiwiwiwiwiwiwiwiwiwiwiwiwiwiwiwiwiwiwiwiwiwiwiwiwiwiwiwiwiwiwiwiwiwiwiwiwiwiwiwiwiwiwiwiwiwiwiwiwiwiwiwiwiwi
wiwiwiwiwiwiwiwiwiwiwiwiwiwiwiwiwiwiwiwiwiwiwiwiwiwiwiwiwiwiwiwiwiwiwiwiwiwiwiwiwiwiwiwiwiwiwiwiwiwiwiwiwiwiwiwiwiwiwiwiwiwiwiwiwiwiwiwiwiwiwiwiwiwiwi
wiwiwiwiwiwiwiwiwiwiwiwiwiwiwiwiwiwiwiwiwiwiwiwiwiwiwiwiwiwiwiwiwiwiwiwiwiwiwiwiwiwiwiwiwiwiwiwiwiwiwiwiwiwiwiwiwiwiwiwiwiwiwiwiwiwiwiwiwiwiwiwiwiwiwi
wiwiwiwiwiwiwiwiwiwiwiwiwiwiwiwiwiwiwiwiwiwiwiwiwiwiwiwiwiwiwiwiwiwiwiwiwiwiwiwiwiwiwiwiwiwiwiwiwiwiwiwiwiwiwiwiwiwiwiwiwiwiwiwiwiwiwiwiwiwiwiwiwiwiwi
wiwiwiwiwiwiwiwiwiwiwiwiwiwiwiwiwiwiwiwiwiwiwiwiwiwiwiwiwiwiwiwiwiwiwiwiwiwiwiwiwiwiwiwiwiwiwiwiwiwiwiwiwiwiwiwiwiwiwiwiwiwiwiwiwiwiwiwiwiwiwiwiwiwiwi
wiwiwiwiwiwiwiwiwiwiwiwiwiwiwiwiwiwiwiwiwiwiwiwiwiwiwiwiwiwiwiwiwiwiwiwiwiwiwiwiwiwiwiwiwiwiwiwiwiwiwiwiwiwiwiwiwiwiwiwiwiwiwiwiwiwiwiwiwiwiwiwiwiwiwi
wiwiwiwiwiwiwiwiwiwiwiwiwiwiwiwiwiwiwiwiwiwiwiwiwiwiwiwiwiwiwiwiwiwiwiwiwiwiwiwiwiwiwiwiwiwiwiwiwiwiwiwiwiwiwiwiwiwiwiwiwiwiwiwiwiwiwiwiwiwiwiwiwiwiwi
wiwiwiwiwiwiwiwiwiwiwiwiwiwiwiwiwiwiwiwiwiwiwiwiwiwiwiwiwiwiwiwiwiwiwiwiwiwiwiwiwiwiwiwiwiwiwiwiwiwiwiwiwiwiwiwiwiwiwiwiwiwiwiwiwiwiwiwiwiwiwiwiwiwiwi
wiwiwiwiwiwiwiwiwiwiwiwiwiwiwiwiwiwiwiwiwiwiwiwiwiwiwiwiwiwiwiwiwiwiwiwiwiwiwiwiwiwiwiwiwiwiwiwiwiwiwiwiwiwiwiwiwiwiwiwiwiwiwiwiwiwiwiwiwiwiwiwiwiwiwi
wiwiwiwiwiwiwiwiwiwiwiwiwiwiwiwiwiwiwiwiwiwiwiwiwiwiwiwiwiwiwiwiwiwiwiwiwiwiwiwiwiwiwiwiwiwiwiwiwiwiwiwiwiwiwiwiwiwiwiwiwiwiwiwiwiwiwiwiwiwiwiwiwiwiwi
wiwiwiwiwiwiwiwiwiwiwiwiwiwiwiwiwiwiwiwiwiwiwiwiwiwiwiwiwiwiwiwiwiwiwiwiwiwiwiwiwiwiwiwiwiwiwiwiwiwiwiwiwiwiwiwiwiwiwiwiwiwiwiwiwiwiwiwiwiwiwiwiwiwiwi
wiwiwiwiwiwiwiwiwiwiwiwiwiwiwiwiwiwiwiwiwiwiwiwiwiwiwiwiwiwiwiwiwiwiwiwiwiwiwiwiwiwiwiwiwiwiwiwiwiwiwiwiwiwiwiwiwiwiwiwiwiwiwiwiwiwiwiwiwiwiwiwiwiwiwi
wiwiwiwiwiwiwiwiwiwiwiwiwiwiwiwiwiwiwiwiwiwiwiwiwiwiwiwiwiwiwiwiwiwiwiwiwiwiwiwiwiwiwiwiwiwiwiwiwiwiwiwiwiwiwiwiwiwiwiwiwiwiwiwiwiwiwiwiwiwiwiwiwiwiwi
wiwiwiwiwiwiwiwiwiwiwiwiwiwiwiwiwiwiwiwiwiwiwiwiwiwiwiwiwiwiwiwiwiwiwiwiwiwiwiwiwiwiwiwiwiwiwiwiwiwiwiwiwiwiwiwiwiwiwiwiwiwiwiwiwiwiwiwiwiwiwiwiwiwiwi
wiwiwiwiwiwiwiwiwiwiwiwiwiwiwiwiwiwiwiwiwiwiwiwiwiwiwiwiwiwiwiwiwiwiwiwiwiwiwiwiwiwiwiwiwiwiwiwiwiwiwiwiwiwiwiwiwiwiwiwiwiwiwiwiwiwiwiwiwiwiwiwiwiwiwi
wiwiwiwiwiwiwiwiwiwiwiwiwiwiwiwiwiwiwiwiwiwiwiwiwiwiwiwiwiwiwiwiwiwiwiwiwiwiwiwiwiwiwiwiwiwiwiwiwiwiwiwiwiwiwiwiwiwiwiwiwiwiwiwiwiwiwiwiwiwiwiwiwiwiwi
wiwiwiwiwiwiwiwiwiwiwiwiwiwiwiwiwiwiwiwiwiwiwiwiwiwiwiwiwiwiwiwiwiwiwiwiwiwiwiwiwiwiwiwiwiwiwiwiwiwiwiwiwiwiwiwiwiwiwiwiwiwiwiwiwiwiwiwiwiwiwiwiwiwiwi
wiwiwiwiwiwiwiwiwiwiwiwiwiwiwiwiwiwiwiwiwiwiwiwiwiwiwiwiwiwiwiwiwiwiwiwiwiwiwiwiwiwiwiwiwiwiwiwiwiwiwiwiwiwiwiwiwiwiwiwiwiwiwiwiwiwiwiwiwiwiwiwiwiwiwi
wiwiwiwiwiwiwiwiwiwiwiwiwiwiwiwiwiwiwiwiwiwiwiwiwiwiwiwiwiwiwiwiwiwiwiwiwiwiwiwiwiwiwiwiwiwiwiwiwiwiwiwiwiwiwiwiwiwiwiwiwiwiwiwiwiwiwiwiwiwiwiwiwiwiwi
wiwiwiwiwiwiwiwiwiwiwiwiwiwiwiwiwiwiwiwiwiwiwiwiwiwiwiwiwiwiwiwiwiwiwiwiwiwiwiwiwiwiwiwiwiwiwiwiwiwiwiwiwiwiwiwiwiwiwiwiwiwiwiwiwiwiwiwiwiwiwiwiwiwiwi
wiwiwiwiwiwiwiwiwiwiwiwiwiwiwiwiwiwiwiwiwiwiwiwiwiwiwiwiwiwiwiwiwiwiwiwiwiwiwiwiwiwiwiwiwiwiwiwiwiwiwiwiwiwiwiwiwiwiwiwiwiwiwiwiwiwiwiwiwiwiwiwiwiwiwi
wiwiwiwiwiwiwiwiwiwiwiwiwiwiwiwiwiwiwiwiwiwiwiwiwiwiwiwiwiwiwiwiwiwiwiwiwiwiwiwiwiwiwiwiwiwiwiwiwiwiwiwiwiwiwiwiwiwiwiwiwiwiwiwiwiwiwiwiwiwiwiwiwiwiwi
wiwiwiwiwiwiwiwiwiwiwiwiwiwiwiwiwiwiwiwiwiwiwiwiwiwiwiwiwiwiwiwiwiwiwiwiwiwiwiwiwiwiwiwiwiwiwiwiwiwiwiwiwiwiwiwiwiwiwiwiwiwiwiwiwiwiwiwiwiwiwiwiwiwiwi
wiwiwiwiwiwiwiwiwiwiwiwiwiwiwiwiwiwiwiwiwiwiwiwiwiwiwiwiwiwiwiwiwiwiwiwiwiwiwiwiwiwiwiwiwiwiwiwiwiwiwiwiwiwiwiwiwiwiwiwiwiwiwiwiwiwiwiwiwiwiwiwiwiwiwi
wiwiwiwiwiwiwiwiwiwiwiwiwiwiwiwiwiwiwiwiwiwiwiwiwiwiwiwiwiwiwiwiwiwiwiwiwiwiwiwiwiwiwiwiwiwiwiwiwiwiwiwiwiwiwiwiwiwiwiwiwiwiwiwiwiwiwiwiwiwiwiwiwiwiwi
wiwiwiwiwiwiwiwiwiwiwiwiwiwiwiwiwiwiwiwiwiwiwiwiwiwiwiwiwiwiwiwiwiwiwiwiwiwiwiwiwiwiwiwiwiwiwiwiwiwiwiwiwiwiwiwiwiwiwiwiwiwiwiwiwiwiwiwiwiwiwiwiwiwiwi
wiwiwiwiwiwiwiwiwiwiwiwiwiwiwiwiwiwiwiwiwiwiwiwiwiwiwiwiwiwiwiwiwiwiwiwiwiwiwiwiwiwiwiwiwiwiwiwiwiwiwiwiwiwiwiwiwiwiwiwiwiwiwiwiwiwiwiwiwiwiwiwiwiwiwi
wiwiwiwiwiwiwiwiwiwiwiwiwiwiwiwiwiwiwiwiwiwiwiwiwiwiwiwiwiwiwiwiwiwiwiwiwiwiwiwiwiwiwiwiwiwiwiwiwiwiwiwiwiwiwiwiwiwiwiwiwiwiwiwiwiwiwiwiwiwiwiwiwiwiwi
wiwiwiwiwiwiwiwiwiwiwiwiwiwiwiwiwiwiwiwiwiwiwiwiwiwiwiwiwiwiwiwiwiwiwiwiwiwiwiwiwiwiwiwiwiwiwiwiwiwiwiwiwiwiwiwiwiwiwiwiwiwiwiwiwiwiwiwiwiwiwiwiwiwiwi
wiwiwiwiwiwiwiwiwiwiwiwiwiwiwiwiwiwiwiwiwiwiwiwiwiwiwiwiwiwiwiwiwiwiwiwiwiwiwiwiwiwiwiwiwiwiwiwiwiwiwiwiwiwiwiwiwiwiwiwiwiwiwiwiwiwiwiwiwiwiwiwiwiwiwi
wiwiwiwiwiwiwiwiwiwiwiwiwiwiwiwiwiwiwiwiwiwiwiwiwiwiwiwiwiwiwiwiwiwiwiwiwiwiwiwiwiwiwiwiwiwiwiwiwiwiwiwiwiwiwiwiwiwiwiwiwiwiwiwiwiwiwiwiwiwiwiwiwiwiwi
wiwiwiwiwiwiwiwiwiwiwiwiwiwiwiwiwiwiwiwiwiwiwiwiwiwiwiwiwiwiwiwiwiwiwiwiwiwiwiwiwiwiwiwiwiwiwiwiwiwiwiwiwiwiwiwiwiwiwiwiwiwiwiwiwiwiwiwiwiwiwiwiwiwiwi
wiwiwiwiwiwiwiwiwiwiwiwiwiwiwiwiwiwiwiwiwiwiwiwiwiwiwiwiwiwiwiwiwiwiwiwiwiwiwiwiwiwiwiwiwiwiwiwiwiwiwiwiwiwiwiwiwiwiwiwiwiwiwiwiwiwiwiwiwiwiwiwiwiwiwi
wiwiwiwiwiwiwiwiwiwiwiwiwiwiwiwiwiwiwiwiwiwiwiwiwiwiwiwiwiwiwiwiwiwiwiwiwiwiwiwiwiwiwiwiwiwiwiwiwiwiwiwiwiwiwiwiwiwiwiwiwiwiwiwiwiwiwiwiwiwiwiwiwiwiwi
wiwiwiwiwiwiwiwiwiwiwiwiwiwiwiwiwiwiwiwiwiwiwiwiwiwiwiwiwiwiwiwiwiwiwiwiwiwiwiwiwiwiwiwiwiwiwiwiwiwiwiwiwiwiwiwiwiwiwiwiwiwiwiwiwiwiwiwiwiwiwiwiwiwiwi
wiwiwiwiwiwiwiwiwiwiwiwiwiwiwiwiwiwiwiwiwiwiwiwiwiwiwiwiwiwiwiwiwiwiwiwiwiwiwiwiwiwiwiwiwiwiwiwiwiwiwiwiwiwiwiwiwiwiwiwiwiwiwiwiwiwiwiwiwiwiwiwiwiwiwi
wiwiwiwiwiwiwiwiwiwiwiwiwiwiwiwiwiwiwiwiwiwiwiwiwiwiwiwiwiwiwiwiwiwiwiwiwiwiwiwiwiwiwiwiwiwiwiwiwiwiwiwiwiwiwiwiwiwiwiwiwiwiwiwiwiwiwiwiwiwiwiwiwiwiwi
wiwiwiwiwiwiwiwiwiwiwiwiwiwiwiwiwiwiwiwiwiwiwiwiwiwiwiwiwiwiwiwiwiwiwiwiwiwiwiwiwiwiwiwiwiwiwiwiwiwiwiwiwiwiwiwiwiwiwiwiwiwiwiwiwiwiwiwiwiwiwiwiwiwiwi
wiwiwiwiwiwiwiwiwiwiwiwiwiwiwiwiwiwiwiwiwiwiwiwiwiwiwiwiwiwiwiwiwiwiwiwiwiwiwiwiwiwiwiwiwiwiwiwiwiwiwiwiwiwiwiwiwiwiwiwiwiwiwiwiwiwiwiwiwiwiwiwiwiwiwi
wiwiwiwiwiwiwiwiwiwiwiwiwiwiwiwiwiwiwiwiwiwiwiwiwiwiwiwiwiwiwiwiwiwiwiwiwiwiwiwiwiwiwiwiwiwiwiwiwiwiwiwiwiwiwiwiwiwiwiwiwiwiwiwiwiwiwiwiwiwiwiwiwiwiwi
wiwiwiwiwiwiwiwiwiwiwiwiwiwiwiwiwiwiwiwiwiwiwiwiwiwiwiwiwiwiwiwiwiwiwiwiwiwiwiwiwiwiwiwiwiwiwiwiwiwiwiwiwiwiwiwiwiwiwiwiwiwiwiwiwiwiwiwiwiwiwiwiwiwiwi
wiwiwiwiwiwiwiwiwiwiwiwiwiwiwiwiwiwiwiwiwiwiwiwiwiwiwiwiwiwiwiwiwiwiwiwiwiwiwiwiwiwiwiwiwiwiwiwiwiwiwiwiwiwiwiwiwiwiwiwiwiwiwiwiwiwiwiwiwiwiwiwiwiwiwi
wiwiwiwiwiwiwiwiwiwiwiwiwiwiwiwiwiwiwiwiwiwiwiwiwiwiwiwiwiwiwiwiwiwiwiwiwiwiwiwiwiwiwiwiwiwiwiwiwiwiwiwiwiwiwiwiwiwiwiwiwiwiwiwiwiwiwiwiwiwiwiwiwiwiwi
wiwiwiwiwiwiwiwiwiwiwiwiwiwiwiwiwiwiwiwiwiwiwiwiwiwiwiwiwiwiwiwiwiwiwiwiwiwiwiwiwiwiwiwiwiwiwiwiwiwiwiwiwiwiwiwiwiwiwiwiwiwiwiwiwiwiwiwiwiwiwiwiwiwiwi
wiwiwiwiwiwiwiwiwiwiwiwiwiwiwiwiwiwiwiwiwiwiwiwiwiwiwiwiwiwiwiwiwiwiwiwiwiwiwiwiwiwiwiwiwiwiwiwiwiwiwiwiwiwiwiwiwiwiwiwiwiwiwiwiwiwiwiwiwiwiwiwiwiwiwi
wiwiwiwiwiwiwiwiwiwiwiwiwiwiwiwiwiwiwiwiwiwiwiwiwiwiwiwiwiwiwiwiwiwiwiwiwiwiwiwiwiwiwiwiwiwiwiwiwiwiwiwiwiwiwiwiwiwiwiwiwiwiwiwiwiwiwiwiwiwiwiwiwiwiwi
wiwiwiwiwiwiwiwiwiwiwiwiwiwiwiwiwiwiwiwiwiwiwiwiwiwiwiwiwiwiwiwiwiwiwiwiwiwiwiwiwiwiwiwiwiwiwiwiwiwiwiwiwiwiwiwiwiwiwiwiwiwiwiwiwiwiwiwiwiwiwiwiwiwiwi
wiwiwiwiwiwiwiwiwiwiwiwiwiwiwiwiwiwiwiwiwiwiwiwiwiwiwiwiwiwiwiwiwiwiwiwiwiwiwiwiwiwiwiwiwiwiwiwiwiwiwiwiwiwiwiwiwiwiwiwiwiwiwiwiwiwiwiwiwiwiwiwiwiwiwi
wiwiwiwiwiwiwiwiwiwiwiwiwiwiwiwiwiwiwiwiwiwiwiwiwiwiwiwiwiwiwiwiwiwiwiwiwiwiwiwiwiwiwiwiwiwiwiwiwiwiwiwiwiwiwiwiwiwiwiwiwiwiwiwiwiwiwiwiwiwiwiwiwiwiwi
wiwiwiwiwiwiwiwiwiwiwiwiwiwiwiwiwiwiwiwiwiwiwiwiwiwiwiwiwiwiwiwiwiwiwiwiwiwiwiwiwiwiwiwiwiwiwiwiwiwiwiwiwiwiwiwiwiwiwiwiwiwiwiwiwiwiwiwiwiwiwiwiwiwiwi
wiwiwiwiwiwiwiwiwiwiwiwiwiwiwiwiwiwiwiwiwiwiwiwiwiwiwiwiwiwiwiwiwiwiwiwiwiwiwiwiwiwiwiwiwiwiwiwiwiwiwiwiwiwiwiwiwiwiwiwiwiwiwiwiwiwiwiwiwiwiwiwiwiwiwi
wiwiwiwiwiwiwiwiwiwiwiwiwiwiwiwiwiwiwiwiwiwiwiwiwiwiwiwiwiwiwiwiwiwiwiwiwiwiwiwiwiwiwiwiwiwiwiwiwiwiwiwiwiwiwiwiwiwiwiwiwiwiwiwiwiwiwiwiwiwiwiwiwiwiwi
wiwiwiwiwiwiwiwiwiwiwiwiwiwiwiwiwiwiwiwiwiwiwiwiwiwiwiwiwiwiwiwiwiwiwiwiwiwiwiwiwiwiwiwiwiwiwiwiwiwiwiwiwiwiwiwiwiwiwiwiwiwiwiwiwiwiwiwiwiwiwiwiwiwiwi
wiwiwiwiwiwiwiwiwiwiwiwiwiwiwiwiwiwiwiwiwiwiwiwiwiwiwiwiwiwiwiwiwiwiwiwiwiwiwiwiwiwiwiwiwiwiwiwiwiwiwiwiwiwiwiwiwiwiwiwiwiwiwiwiwiwiwiwiwiwiwiwiwiwiwi
wiwiwiwiwiwiwiwiwiwiwiwiwiwiwiwiwiwiwiwiwiwiwiwiwiwiwiwiwiwiwiwiwiwiwiwiwiwiwiwiwiwiwiwiwiwiwiwiwiwiwiwiwiwiwiwiwiwiwiwiwiwiwiwiwiwiwiwiwiwiwiwiwiwiwi
wiwiwiwiwiwiwiwiwiwiwiwiwiwiwiwiwiwiwiwiwiwiwiwiwiwiwiwiwiwiwiwiwiwiwiwiwiwiwiwiwiwiwiwiwiwiwiwiwiwiwiwiwiwiwiwiwiwiwiwiwiwiwiwiwiwiwiwiwiwiwiwiwiwiwi
wiwiwiwiwiwiwiwiwiwiwiwiwiwiwiwiwiwiwiwiwiwiwiwiwiwiwiwiwiwiwiwiwiwiwiwiwiwiwiwiwiwiwiwiwiwiwiwiwiwiwiwiwiwiwiwiwiwiwiwiwiwiwiwiwiwiwiwiwiwiwiwiwiwiwi
yRyRyRyRyRyRyRyRyRyRwiwiwiwiwiwiwiwiwiwiwiwiwiwiwiwiwiwiwiwiwiwiwiwiwiwiwiwiwiwiwiwiwiwiwiwiwiwiwiwiwiwiwiwiwiwiwiwiwiwiwiwiwiwiwiwiwiwiwiwiwiwiwiwiwi
yRuWNuNuNuNuuWuWuWyRwiwiwiwiwiwiwiwiwiwiwiwiwiwiwiwiwiwiwiwiwiwiwiwiwiwiwiwiwiwiwiwiwiwiwiwiwiwiwiwiwiwiwiwiwiwiwiwiwiwiwiwiwiwiwiwiwiwiwiwiwiwiwiwiwi
yRXrXrXrXrXrXrXrXryRwiwiwiwiwiwiwiwiwiwiwiwiwiwiwiwiwiwiwiwiwiwiwiwiwiwiwiwiwiwiwiwiwiwiwiwiwiwiwiwiwiwiwiwiwiwiwiwiwiwiwiwiwiwiwiwiwiwiwiwiwiwiwiwiwi
yRCJCJCJCJCJCJCJCJyRwiwiwiwiwiwiwiwiwiwiwiwiwiwiwiwiwiwiwiwiwiwiwiwiwiwiwiwiwiwiwiwiwiwiwiwiwiwiwiwiwiwiwiwiwiwiwiwiwiwiwiwiwiwiwiwiwiwiwiwiwiwiwiwiwi
yRYrYrYrYrYrYrYrYryRwiwiwiwiwiwiwiwiwiwiwiwiwiwiwiwiwiwiwiwiwiwiwiwiwiwiwiwiwiwiwiwiwiwiwiwiwiwiwiwiwiwiwiwiwiwiwiwiwiwiwiwiwiwiwiwiwiwiwiwiwiwiwiwiwi
yRuWuWuWuWOnNuNuuWyRwiwiwiwiwiwiwiwiwiwiwiwiwiwiwiwiwiwiwiwiwiwiwiwiwiwiwiwiwiwiwiwiwiwiwiwiwiwiwiwiwiwiwiwiwiwiwiwiwiwiwiwiwiwiwiwiwiwiwiwiwiwiwiwiwi
yRtxtxtYcwtxtxtxaOyRwiwiwiwiwiwiwiwiwiwiwiwiwiwiwiwiwiwiwiwiwiwiwiwiwiwiwiwiwiwiwiwiwiwiwiwiwiwiwiwiwiwiwiwiwiwiwiwiwiwiwiwiwiwiwiwiwiwiwiwiwiwiwiwiwi
yRtKJdiItKtKtKtKtKyRwiwiwiwiwiwiwiwiwiwiwiwiwiwiwiwiwiwiwiwiwiwiwiwiwiwiwiwiwiwiwiwiwiwiwiwiwiwiwiwiwiwiwiwiwiwiwiwiwiwiwiwiwiwiwiwiwiwiwiwiwiwiwiwiwi
yRtKJdtKJdtKtKJdJdyRwiwiwiwiwiwiwiwiwiwiwiwiwiwiwiwiwiwiwiwiwiwiwiwiwiwiwiwiwiwiwiwiwiwiwiwiwiwiwiwiwiwiwiwiwiwiwiwiwiwiwiwiwiwiwiwiwiwiwiwiwiwiwiwiwi
yRJdtKbAtKtKJdtKJdyRwiwiwiwiwiwiwiwiwiwiwiwiwiwiwiwiwiwiwiwiwiwiwiwiwiwiwiwiwiwiwiwiwiwiwiwiwiwiwiwiwiwiwiwiwiwiwiwiwiwiwiwiwiwiwiwiwiwiwiwiwiwiwiwiwi
yRtKJdtKtKDRtKJdtKyRwiwiwiwiwiwiwiwiwiwiwiwiwiwiwiwiwiwiwiwiwiwiwiwiwiwiwiwiwiwiwiwiwiwiwiwiwiwiwiwiwiwiwiwiwiwiwiwiwiwiwiwiwiwiwiwiwiwiwiwiwiwiwiwiwi
yRyRyRyRyRyRyRyRyRyRwiwiwiwiwiwiwiwiwiwiwiwiwiwiwiwiwiwiwiwiwiwiwiwiwiwiwiwiwiwiwiwiwiwiwiwiwiwiwiwiwiwiwiwiwiwiwiwiwiwiwiwiwiwiwiwiwiwiwiwiwiwiwiwiwi
"}
